NO ./textures/block/wall.xpm
SO ./textures/block/wall.xpm
WE ./textures/block/wall.xpm
EA ./textures/block/wall.xpm

F 153, 133, 129
C 88, 173, 224

1111111111111111111111111111111
1000000000000000000000000000001
1011111111111111111111111111101
1010000000000000000000000000101
1010111111111111111111111110101
101010000000N000000000000000101
1010111111111111111111111110101
1010000000000000000000000000101
1010111111111111111111111110101
1111111111111111111111111111111