NO ./textures/block/block.xpm
SO ./textures/block/command.xpm
WE ./textures/block/composter.xpm
EA ./textures/block/deadtube.xpm

F 153, 133, 129
C 88, 173, 224


            1111111111111111111111111111
            1000000000000000000000000001
        11111101111111111111111111000001
        10000001000000000000000001000011
11111111101111101111101111111101011111
10000000000000100000100000000101000001
10111111111110111110111111110101111101
10000000000000000000100000000000000001
11110111111111111110111111111111111011
10000100001   10000010N0000MD000001001
10111101111111111111101111111111001001
10000101000000000000001000000000001001
11110101111111101111111111111111101001
10000000000000D00000000000000000101001
10111111111110111111111111111110101001
10000000000000000000000000000000001001
11111111111111111111111111111111111111