NO ./textures/NO.xpm
SO ./textures/south.xpm
WE ./textures/west.xpm
EA ./textures/east.xpm

F 220,100,0
C 225,30 ,0

            1111111111111111111111111111
            1000000000000000000000000001
        11111101111111111111111111000001
        10000001000000000000000001000011
11111111101111101111101111111101011111
10000000000000100000100000000101000001
10111111111110111110111111110101111101
10000000000000000000100000000000000001
11110111111111111110111111111111111011
1000010000000000000010N000000000001001
10111101111111111111101111111111001001
10000101000000000000001000000000001001
11110101111111101111111111111111101001
10000000000000100000000000000000101001
10111111111110111111111111111110101001
10000000000000000000000000000000001001
11111111111111111111111111111111111111