NO ./textures/block/block.xpm
SO ./textures/block/command.xpm
WE ./textures/block/composter.xpm
EA ./textures/block/deadtube.xpm

F 220,250,250
C 220,250,250

111111111111111111111111111111
100000000000001000000000000001
101111111111101011111111111101
101000000000101010000000000101
10101111111010D010111111110101
101010000010101010100000010101
10D010M0M01010101010M00M010101
101111111110101010111111110101
100000000000001010000000000101
11111111111111101111111D111101
100000000000000000000000000001
101111111D11111111111111111101
101000000000001000000000000101
101011111111101011111111110101
101010000000101010000000010101
10101011111010D010111111010101
1010D0100010101010100001010101
10111110N011101011100001110101
100000M000M0001000M00M00000101
111111111111111111111111111111