NO ./textures/block/block.xpm
SO ./textures/block/deepslate.xpm
WE ./textures/block/composter.xpm
EA ./textures/block/deadtube.xpm

F 0,0,0
C 0,0,0

      1111111111111111
      1000M000000M0001
  111110111111111111011111
  10000010000000M001000001
1110111010111111110101110111
10001010D0100M00010D01010001
10M0D010101011110101010D0M01
1110101010D01001010101010111
  101010101010N10101010101
11101010101011D1010101010111
10M0D010101000000101010D0M01
10001010D0111111110D01010001
1110111010000M00000101110111
  100000111111111111000001
  11111010M000000M01011111
      1000000110000001
      1111111111111111
