NO ./n.xpm
SO ./s.xpm
WE ./w.xpm
EA ./e.xpm
F 10,20,30
C 30,20,10

111111
1 1001
111N01
10M001
111111
