NO ./n.xpm
SO ./s.xpm
WE ./w.xpm
EA ./e.xpm
F 1,2,3
C 4,5,6

111111111
1000001
100001
10N001
11111111
