NO ./n.xpm
SO ./s.xpm
WE ./w.xpm
EA ./e.xpm
F 0,0,0
C 255,255,255

11111
10N01
10001
11100
11111
